0000090000
0009000000
0000900900
0090000000
0090090000
0900000900
0900000000
0900000090
0009000090
0009000000